################################################################################
### ## #                        # ###################               ##########M#
### ## ######################## # #    ##    ##    ## ############# ##    ##   #
#                               # # ## ## ## ## ## ## #             ## ## ## ###
### ## ######################## # # ## ## ## ## ## ## # ############## ## ## ###
### ## #                     ## #   ##    ##    ##    #                 #    ###
### ## # ################### ## # ##############################################
### ## ##################### ## #                                              #
### ##                       ## ############################################## #
###############################                                                #
#                            ################################################# #
# ##########################                                          ######## #
# ############    ################################################### ######## #
#              ## ##   ##   #    ##    ##    ##    ########      ####          #
################  ## # ## # # ## ## ## ## ## ## ## ###    # #### ###############
#    ###       #     #    #   ##    ##    ##    ##     ## # ##                ##
# ## ##### ### ########################################## # ## ##   ## ###### ##
# #        ##                                             # ## ## #  # ###### ##
# ######################################################### ## ## #### ###### ##
#                                                           ## ##      ###### ##
############################################################################# ##
*%Z                                                                           ##
################################################################################
