################################################################################
#                       ##   ###      ## # ###       #   #######################
# ################### # ## # ### ## # ## # ### ##### # # #######################
# #                 # # ## # ### ## # ## # ### ##    # #                       #
# # ############### # # ## # ### ## # ## # ### ## #### ####################### #
# # #             # # # ## # ### ## # ## #     ## ###  ####################### #
# # # ########### # # # ## # ### ## # ## # ###### ###     #                    #
# # # ## ######## # # # ## # ### ## # ## # #      ####### # ####################
# # # ##          # # # ## #     ## #      #              #                M####
# # #  ############ # # ## ##################################################  #
# # ##              # # ##                                                     #
# # ################# # ###################################################### #
# #                   #                         ############################## #
# #############################################                                #
#                                       ########################################
####### ############################### ########################################
### ### #                               ###               ###################   
### ### #                           ####### ############# #    ##    ##    ## # 
### ### ################################### ##            # ## ## ## ## ## ## # 
#                                           ## ############ ## ## ## ## ## #  # 
### ##########################################              ##    ##    ##   ## 
##############################################################################  
#*%Z                                                                           #
