::::::::::::::::::::::::::::::::::::::::::::::::::::::::::::::::::::::::::::::::
:Z::                                                                       ::*::
::::                                                                       :::::
::                                                                            ::
::                                                                            ::
::                                                                            ::
::                                                                       #    ::
::                  #                                   #               ##    ::
::  #########  #    #  ######              ######  ##   #  #######      ##    ::
::      #      #    #  #                   #       ###  #  #     #      ##    ::
::      #      ######  ###                 ###     # ## #  #     #      #     ::
::      #      #    #  #                   #       #  ###  #    ##            ::
::      #      #    #  ######              ######  #   ##  ######       ##    ::
::                                                      #                     ::
::                                                                            ::
::                                                                            ::
::                                                                            ::
::                                                                            ::
::                                #####  ###   #####     #  #   ###   #   #   ::
::                                #     #   #  #   #     ## #  #   #  #   #   ::
:::::                             ###   #   #  # ##      # ##  #   #  # # #   ::
::*::              #  #  #  #  #  #      ###   #   #     #  #   ###    # #    ::
::::::::::::::::::::::::::::::::::::::::::::::::::::::::::::::::::::::::::::::::
