###############################################################################
Z       #     |       |     |             #     |     |     |   |   |         |
# ####### | | ||| ||||| | | | ||||||| ||| ### | | | | | ||| | | | | ||| ||||| |
#         | |   |       | | | |       |       | | | |   | | | |   |   | |     |
# ||||||||| ||| ||||||||| | ||| ||||||| ####### | | ||||| | | ||||||| ||| |||||
# |       | |       |     |     |   |   | |     | |   |   |   |     | |   |   |
# ||||| | | ||||||| | ||||| ||||| | ||| | | ||| | ||| | ||||| | ||| | | ||| | |
#     | | |     | |   |     |     |   |   |   | | |   |     | | |   |   |   | |
#|||| ||| ||||| | ||||| ||||| ||||||| ||| ||| | | | ||||| | | | | ||||||| ||| |
#   |   |     | |       |     |       |   |   | | |     | | | | | |         | |
# | ||| ||||| | ||| ||||| ||||| ||||||||||| ||| | ||||| | ||| | | | |||||||||M|
# |   |     | |   |     | |   |             | |     |   |     | | |   |   |   |
# ||||||||| | ||| ||||| | | | ||||||||||||||| ||||||| ||| ||||| | ||| | | | | |
#         |   | |     | | | |     |   |           |   | | | |   |     | | | | |
# ||| ||| ||| | ||||| ||| | | ||| | | ||| ||| ||||| ||| | | | ||||||||| | | |||
# | |   | |   |   |   |   | | |     |   |   |     | |   |   |   |       | |   |
# | ||| | | ||||| | | | ||||| ||||||||| ||||||| | | | ||||| ||| | ||||| | ||| |
#   | | | |       | | | |   |     |   |       | | | |       |   | |     | | | |
#|| | | ||||||||| | ||| | | ||||| | ||||||||| ||| | ||||||||| ||||| ||||| | | |
#     |           |       |       |               |                 |       |  
###############################################################################
