:::::::::::::::::::::::::::::::::::::::
Z                           :   :     :
: ::::::::::::: ::::::: ::: : : : : :::
:   :   :     :   :     :   : : : :   :
::: ::: : ::: ::::: ::::::: : ::: ::: :
:   :   : : : :   :       : :   : :   :
: ::: ::: : : : : ::: ::: : ::: : : : :
:     :   :     :   : :   :   :   : : :
: ::::: ::: ::::::: : : ::::: : ::: : :
: :     : :   :   : : : :     :   : : :
::: ::::: ::: : : : ::: : ::::::::: : :
:   :   :     : : :     :   :       : :
: : : : ::::: : : ::::::::: ::: ::::: :
: : : :     : : :     :   :   :   :   :
: : : ::::: ::: ::::: : ::::: : : : :::
: : :     :     : :   :       : : :   :
: : ::::: ::::::: : ::: ::::::::: :::::
: :   :   :       : :             :   :
: ::: : ::: : ::: : ::::::::::::::: : :
: :   : :   : : : :   :         :   : :
: ::::: ::::: : : ::: : ::::::: : ::: :
:             :     :         :     : M
:::::::::::::::::::::::::::::::::::::::
