########################################
#                                      #
# ################  ################## #
# #            ##   #    #    ######## #
# # ### ###### ##   # ## # ##        # #
# #        M##        ##   ## ###### # #
# ################  ######### ###### # #
#                             #      # #
##################  #### #### ######## #
#               #          ######  M   #
# ############# ##  #######       ######
#    #        #           # #### ##    #
#### ###### # ####  ### # ###### ## ## #
#           #         # # #       #  # #
############# ####  # # # # #####  # # #
#           # ##    # # # #   ###### # #
# ######### #       # # # ###        # #
# #       # ######  # # #   ########## #
# #                   #   #            #
# ################  ####################
#                                      #
##################  ################## #
#Z                                     #
